三伏天卖烂鱼	臭货 货臭
睡梦里逮鸟	空扑一场
老母鸡啄秕谷	上了当
飞机上摇橹	空划
赵匡胤送京娘	成人之美 御驾亲征
瞎娘抱着秃娃娃	人家不夸自家夸
黑瞎子吃告示	满肚子熊章程
脑门儿上戴眼镜	眼高
额角头碰着天花板	真高
刘姥姥进了大观园	什么都是有趣的
尿瘪子打酒	满不在壶 满不在乎
蜘蛛的腿	又干又瘦
拽着羊胡子过河	牵须 谦虚
天涩背稿件	越背越重
谷子地里的高粱	冒尖了 冒尖
书房里燃炮仗	乱放炮
哑巴做梦娶媳妇	美在心里
一笔画眉毛	只图眼前 只涂眼前
一手交钱一手交货	谁也不欠谁的
死鸭崽	嘴巴还挺硬
太平洋上里巡警	管里宽
公主手里的绣球	专打上眼的
踩着刀尖进虎口	步步危险
猪八戒头上插花	丑上加怪
口吞匕首	伤透心肝 伤心
绑到绳上的蚂蚁	由不得你
无耳茶褒	得把嘴
皮球裂了口	泄气了 泄气
孵豆芽	憋屈够了
街头演出	没后台
罐里弄王八	越养越娇
对着棺材撤尿	欺侮死人
大豹借猪	有去没回
墨蚊咬柱子	无痛痒
葫芦壳挂在颈上	自找麻烦
一炮换双士	代价不算低
蝼蛄啃秫秸	不是那路虫
大脚女人走路	迈不上小步子
踏扁了的蛤蟆	瘪了气啦
山崖上的葡萄	一提就是一大串
瞎闺女赶会	凑热闹 趁热闹
腰里别着死耗子	假充好猎手 冒充打猎的
剥皮的鱼儿	片甲不留
眼里阔瓜子	哪里开的口
马背上的高手	奇才 骑才
驼子掼一跤	两头勿着实
鸭子嘴里插棒槌	转不过脖来
小偷讲评书	贼能白话
蛇岛上寻宝	凶多吉少
猫不吃死耗子	假斯文 假意慈悲
正月看花灯	凑热闹
河里找匕首	唠叨 捞刀
小干买馒头	拣大搬
老哇子堪蚌壳	光听到嘴响
三个王八少两爪	失足
山岗看放荒	再不能扑灭了火
瞎爷爷过河	有步数
头顶袜子	不是脚
唱戏打水桶	算啥家伙
蚂蚁搬蛋往上爬	必涨洪水
小偷跑百米	贼快
寡妇捶肚子	自家有鬼自家知
坐坑沿打滑曲律	一溜下去
半天空里跑马	露了蹄脚
茅房里敲铴锣	臭美一铛铛
土地佬吃汤圆	神不愣神 神不能神
老鼠子尾巴儿打八棒槌	肿也肿不到好粗
一个月穿三十双鞋	日日换新
火车对开	一掠而过
医生戴口罩	嘴上一套
苍蝇戴龙眼壳	盖头盖面
屎壳郎的房子	空的
马二巴下河	拿鸭子 拿丫子
缺巴齿吃油面	拖进拖出 一望无涯 一望无牙
做梦拜堂	暗喜 暗喜欢 暗暗欢喜
老鼠洞口放粮食	找着地方了
割柴的拿斧头	不要脸 不要镰
浆糊锅里煮电灯泡	说他混球他还一肚子邪火
板斧劈柴	一面砍
火车站的挂钟	群众观点
鲜花插在牛粪上	不般配 糟蹋了 不配 不相配 太可惜了 可惜 不惜材料 臭美
一块石头掉井里	不懂 扑腾
袜筒子里别胡椒	辣腿 拿腿
裕溪口的纤	搭到就背 搭上就背
徐稚破除迷信	以错攻错
生就的眉毛长就的须	难改
燕窝里停坟	来了紧了 来龙紧了
串马尥蹶子	乱了套
空肚子打嗝	强装吃饱了饭
屎壳郎掉进蒜臼里	装蒜
驼子的背	翘起来的 难医
猴儿脸	说变就变 说翻就翻
茅房里作揖	臭奉承
月亮地里耍弯刀	明砍
割脖子的鸡还想飞	垂死挣扎
猴儿拉稀	坏了肠子 坏了肠子了 坏肠子
腊月上席	自不带盐 自不待言
老鳖请客	净是些王八
茅坑里打灯笼	照屎 找死
老虎套车	不敢拦
厕所里点灯笼	找死 照屎 找屎
儿媳妇向公公借钱	挪用公款
老猴偷苞米	专找嫩的捏
土地爷的探子	不是担载的鬼
石灰浆写文章	尽是白字 净写白字 净写别字 尽白字 竟写白字
三分钱买个小黑瞎子	熊玩艺 熊玩意儿
寿星老上吊	怨命长 活得不耐烦了 活腻了 嫌命长
老鼠找大枪	窝里逞能
灶膛抡锤子	砸锅
旧佛添新装	莘庄
拖泥萝卜	吃一段揩一段 揩一段吃一段
做梦捡到金子	尽想好事
瓜飘里点灯	漂亮 瓢亮
大嘴老鸹学八哥叫	不是好腔调
尖嘴骡子卖驴价	坏在嘴上
脏水洗手尿涮锅,洗脸盆里捏窝窝	假干净
打肚皮走钢丝	挺而走险 铤而走险
猴子戴礼帽	假充人
红萝卜蘸辣子	吃出看不出
十王殿里的黑无常	一世无笑脸
半夜里捡得封包	谁来数你
雨后送斗笠	假人情
请神却请到了鬼	瞎了眼
常胜将军还朝	凯旋归来
老鼠掉进米缸里	因祸得福 一半喜一半忧
先动手后聊天	干好了再说
铁匠的风箱	柔能克刚
黄牛食草	吞吞吐吐
十个手指头	长短不齐
拉洋车的打天秤	拿不住了
冰上的爬犁	溜得快
糖稀粘蚊子	挨边跑不掉
树叶掉在江心里	随波逐流
双手托刺猬	难耍
猢狲头浪贴金	稀奇勿煞
往瘸子腿上踢脚	不近人情
蚂蚁上蒸锅	死路一条
胶皮钉子	不软不硬
沾牙的烧饼	面生
抱着书本骑驴子	走着瞧
耗子上了夹	没命了
卖豆沫的不喊	没缸子了
刚吃过黄连吃蜜糖	苦尽甘来
扮秦桧的不卸装	谁没见过你个二花脸 谁没见过你这个二花脸
屁眼子插炮竹	响不得 想不得
三个钱买个蜡烛	独照我
哑巴拜佛	只管磕头不说话
荞麦开花	白啦 一片白
由大街转入巷子	路子越走越窄
小孩子打架	常事 常有的事
三十晚上的菜板	不得空
土地爷掉到井里	捞不起大驾 劳不起大驾
吹了灯瞪眼睛	出了气人又不得罪 出了气又不得罪人 出了气也没得罪人 随机应变
成熟的荔枝	红了脸
鞋底粘了海绵	一点声音都没有
圪针笼里逮蚂蚱	难下手 无法下手
驴子拉磨	任人摆布 转来转去还是老地方 走的老道儿 跑不出这个圈 兜圈子 原地打转 走老道 走老路
死葫芦秤砣	铁了心
贾府的姑娘嫁贾家	假上加假
额骨头上顶扁担	头挑
朽木塔楼房	不稳当 不稳
上炕不点灯	瞎摸
大麻疯晒日头	俏皮 翘皮
腊月三十催年猪	来不及了
过了年的萝卜	走味儿
弯腰捡稻草	轻而易举
哑子捉贼	难开口 急在心头
兔子长尾巴	长不了
外厨房里的灶王爷	独坐儿 独座儿
房檐前的冰凌	根子在上头
蝎子钻进砒霜粉里	浑身是毒 毒极了 最毒
棺材铺里冒烟	阴阳怪气
小孩摆神位	你哄我,我哄你
一个眼的判官	瞎鬼
屙屎捡银子	碰上的财富
睡大桌盖团簸	随得方就得园
小孩儿不认识下棋	走字儿
老虎和猪养的	又恶又蠢
檀香木劈劈柴	大材小用
搬倒树摸老鸹	照老稳处办
驼子睡碾槽	以弯就弯
吃了哑巴药	开不得口
不倒翁掉在铜盆里	哪碰哪响
五匹子拖稻草	晃大
判决书做衣服	混身是罪
缺口碗盛浆糊	白流
未出窝的麻雀嘴朝外	挨着了就吃
吹糖的人改行	不想做人了
放屁拉响抽屉	遮盖脸
十文钱掉了一文	久闻 九文
猴子爬杆狗钻圈,黄鼠狼专钻水道眼儿	各有各的门道
哑子黄连	有苦说勿出
虎咬石狮子	没有人味
弟兄们分家	单干 另起炉灶
金瓜配银瓜	两个顶呱呱
米臼捣沙	实言 石研
戏台底下掉泪	替古人担忧
瓜地里选瓜	越看眼越花
石匠断磨	实打实铲 石打石铲
落雨汤粉丝	有腔
人造革做鼓皮	不响
开水里擀面	没法下手
躺在粪坑边睡觉	不知臭 不知丑
哑巴同床睡	没说的
吴趋坊看会	老等
癞蛤蟆过河	一鼓作气
手指上戴钢箍	顶真 顶针
大雁吃莲秆儿	直脖儿了
糖包子蘸碱水	自讨苦吃 自找苦吃
城头上吊帘子	没门
草窝里抓刺猬	不好下手
老太婆穿线	推位一线
磕一个头放两个屁	行好没有作恶多 行善没有作恶多 行好没有作恶的多
王伦当寨主	没人投奔 安不得人
槽里吃食,圈上操痒	快活畜牲
大公鸡斗架	全凭一张嘴
玉泉山的水甜	远水不解近渴
丝线搭桥	难过
喝蜂糖说好话	甜言蜜语
骑驴子看唱本	走着瞧
土谷蛇生蝎子	屙毒 恶毒
染坊里上吊	色鬼
岳庙里戏台	多搭
火烧纸马铺	落得做人情 迟早要归天
小囡吃泡泡糖	吞吞吐吐
叫花子进庙	穷祷告
乌纸画乌虎	睇不着
十二岁进敬老院	莫把福享早了 享福太早
汰脚布揩面	勿分上下 不分上下
谷筛罩的	一眼看穿
棉花店关门	不弹了 不谈了
扛青扛夹板的	惹不起
麦秆儿上插针	节外生枝
顶了石臼掉狮子	吃力勿讨俏
死灰冒烟	想复燃
茅厕板上捡手帕	揩得口 开得口
老乌龟	又精又硬
军事家的论文	纸上谈兵
叫化子请过年	大家挨饿
旦包子长吓天大	也是个旮出货
高山有好水,平地有好花	各有所长
麻雀入了猫口	不死也要脱身毛
老虎进口袋	自己找死
阎王老爷不戴帽	鬼头鬼脑
麦子地里点绿豆	杂种
纸做栏杆	没依靠 不能依靠
猴子争衔烟斗	假装
心里头结冰块	凉透了 凉透心 冷透心
往炉灶里泼水	憋气又窝火
胸前划十字	上帝保佑 上帝保佐
玻璃人儿	透极了
怀里抱冰	心寒 寒透心了
马上吃猪蹄	不知骨头落那里 骨头不知在那里 不知骨头落哪里了
三个手指捏田螺	万无一失
老鼠钻人风箱	两头受气
三羊止步	六角停 六角亭
头顶生疮脚底流浓	环透
讨饭吃牵外猴	穷欢乐
肥佬穿笠衫	几大就几大
航船上的臭虫	老吃客
单膀鱼	难浮水
泥鳅进汤锅	看你往哪钻
火烧灯笼	露了骨 露骨
躺在棺材里睡觉	没人找你
墙上的裂缝	合不拢 合不到一块
风吹草人	难免动摇
拿大顶看世界	一切颠倒
豆腐跌在灰堆上了	吹不得打不得
信虎的眼睛	灰蓝蛋
和尚误了做,老婆误了娶	两下里都耽搁了 两下里耽搁
你卖门神他卖鬼	同行
横垄地撵瘸子	一步赶不上,步步赶不上
引狼入室	自取灭亡 不顾后患 自招祸灾 自招灾祸
猫不偷鱼吃	假正经
炉坑里烧山药	灰疙瘩
井里的蛤蟆戴草帽	没见过蓝天
活人能叫尿憋死	怪事一桩 怪事
岳口截河的巴子	吃也后悔,不吃也后悔
小铁匠做官	打字当头
千里马竞赛	你快我也快
挂了蚊帐点蚊香	多此一举
癞蛤蟆装鞍子	骑怪 奇怪
黑瞎子遮太阳	手大捂不过天来 手再大也捂不过天来 手大捂不住天
大山装肚里	不觉胀
钟馗站在十字路	四下拿邪
一丈布卖唠九尺两	就尔哈一吃两
喔尿洗碗	一举两得
拿别人的仔打赌	不心痛
呆子求晴	有理说不清
又踢又咬的鸭子	难合群 不合群
哑巴做证	有口难言 有回难吉
月里娃喝凉水	胎焦 太焦
五明头的鸡儿	乱叫
山蚂蜂过河	带毒 带肚
大JS日嫩批	一百 一掰
花篮提水	一场空
年五更打了个兔子	有它过年,没它也过年
潘仁美的脚板子	里勾外联
狐狸窝里的萝卜	骚货 臊货
尿鳖子盛酒	不是正经东西 满不在壶 满不在乎
萤火虫触屁股	亮打亮
三个字的匾	但求腾
缺牙巴吃豆子	原进原出
王先生看报	一塌糊涂
送死人的车马	纸糊的
药料里格甘草	百搭
拄着拐棍下炭窑	处处倒霉 处处捣煤
饭锅里冒烟	米糊了 迷糊了 米煳了
茶灶子搬家	另起炉灶
齐头山蚂蚱	老油子 老资格
喇叭的儿子	小广播
老虎扑苍蝇	小事大办
网上胡侃	谁也不知道谁
猪八戒背孙悟空	能人背后有能人
猴子叼烟卷	像人不是人
蝎子虎子打喷嚏	满嘴喷尿
嘴里扛在肩上	到处吃人家
城隍老爷掷骰子	净是鬼点子 鬼点子多
蚍蜉撼树	不自量力
头顶上演杂技	人上人
长秆打猴	爬到高处去了
兔子没毛	装就材料
粥铺里的买卖	热闹一早
豆芽长上了天	也是菜货
开挂面铺的	没短的
兔子蹦到油锅里	送上嘴的好菜
财到光棍手,有去�踊赝�	不可靠 常事 常识 当然如此
六十日无宅基	赶搬场
买腌鲜鱼放生	不管死活
戏台下掉眼泪	替古人担忧
驼子跌跟斗	两头勿着实 两头不着实 两头不着落
骆驼下骡	怪种
坑缸里石头	又臭又硬
打虾公,买烟抽	水里来,火里去
掉片树叶怕碰头	胆小怕事
卖砖头砌窑	砖款砖用 专款专用
借钱不治病	自己跟自己过不去
打铁烤糊了裤裆	没看火色
新兴庙的菩萨	宜远不宜近
公公驮媳妇过河	出力不讨好
车轱辘断轴	滚了
大年初三贴春联	晚了
土地爷的拐杖	神道 神捣
羊羔跟水牛顶角	输定了 败得惨
大拇手指卷煎饼	自己吃自己 自吃自
寿星跳舞	老天真
鸡子赶鸭子	管过了界
一口吞下热红薯	难咽
留声机片	转着圆圈说
抱着琵琶进磨房	对牛弹琴
小孩儿耍菜刀	不是玩艺儿 不是玩意儿
寡妇见了夜壶哭	你比我强
一块肥肉藏在饭碗底	有人情显不出来
掉到海里的针	没处抓没处捞
犯风的灶火	倒烟
沙滩上撑船	进退两难
要乜贴背了个醋葫芦	穷酸
坟墓里起烟	鬼火乱冒
猴娃卖画张哩	卖不完就抓完了
赤膊跌进麦芒堆	浑身难受
桑拿房子里穿衣服	汗流浃背
驼子挑水	两头不着实
落地风扇转动	不断地摇头
电线杆子晒衣服	好大的架子
牛角挂把草	捎带不费力
茅缸上搓绳	绑死
二十七的月亮	有点盼头
卖糖稀的想盖大楼	熬着吧
癞蛤蟆鼓气	装相
深潭上打虾公	脱了裤来
哑巴嘴里插指头	掏不出话来
冷水��鸡	一毛不拔
包头镰刀	揽头宽
阉过的公牛	硬不起
猴儿上树	爬得快 老练
蝎子掉进了江里	浙江 蛰江
菩萨心肠	心善 大慈大悲
走了豺狼来了虎	一个更比一个凶 一个比一个恶
一拳头打破三床被子	过絮,过絮,再过絮
三个女人在一搭	像群鸭
拴在树桩上的叫驴	尽绕圈子 绕圈子 净绕圈子
木匠打墨线	照直进 照直绷 绷直 绷绷
玉娘峰上立暖壶	高水瓶 高水平
蜜蜂见了花儿	拼命往里钻
自行车挂飞轮	加快了
三九天光脑袋	大动脑筋 大冻脑筋
十字街贴广告	众所周知
心大肚子婆娘送月礼	礼还一礼
驴子推磨	走的老道 走的老道儿 走老道 跑不出这个圈 圆扯圆
隔着门缝儿瞧人	把人看扁
粥铺的买卖	热闹一早儿
破帆使风	不快
新兵打仗	初次上阵
要饭看丈母	穷孝顺
老裁缝做衣裳	不肥不瘦
才出锅的糍粑	酥软
半天空里掉下一条腿	不是凡脚 不是凡角
腊月萝卜满院滚	少窖 少教
一百只麻雀炒一碟子	一窝子小嘴
赤沟子坐砚瓦	墨透膛了 霉透膛了
过期的鸡蛋	臭在里面
半夜里的铺盖	没人理
船破偏遇顶头风	祸不单行
两亲家扎日子	看好
割了驴球敬神	驴也割死了,神也惹下了
莲蓬秆打人	丝情不断 私情不断
胡敬德炒米泡	黑人扒沙 吓人巴煞 黑人巴沙
小猫盖屎	瞎应付
老和尚吹笙	一气儿憋
西城楼上的孔明	嘴说不怕心里惊
坛子里放炮仗	闷声闷气
世上就一个便宜	让王花儿瞅了
老虎嘴边的胡须	谁敢去摸
干鱼里寻胆	难找
屎壳郎上饭桌	恶心 讨厌
灶王爷不吃豆	拿糖
怀里揣笊篱	捞心了 劳心了 心眼多 光捞那份心 光劳那份心 心眼不少 捞的哪份心 劳的哪份心
放屁带出屎	臭上加臭
老母猪爬楼梯	高攀 想高攀
花籽喂牲口	好料 不是好料
引线头上戳芝麻	勿容易
热石头浪蚂蚁	走投无路
阎王开店铺	做鬼的买卖
小孩装老虎	不吓人
唱戏拿鞭子	走人
驼背公挨雨淋	背湿 背时
斧头刮胡须	少见
裤腰带缠在脖子上	系错了 记错了
和尚坐火箭	突飞猛进 秃飞猛进
老鼠咬棺材	死的出不去,活的倒往里钻
蹲在茅坑里问香臭	明知故问
聋子地耳朵	摆式
堵窝捉鸟	拿个稳
飞机上挂水瓶	高水瓶 高水平
端着香炉打喷嚏	弄一脸灰 落了一脸灰
狗的牙齿	参差不齐
阎王老婆怀孕	心怀鬼胎
唱戏的打转	走过场
冷眼看螃蟹	看你横行到几时
老虎吃樱桃	馋红了眼
芋头轮流当母芋	不例外
鸟儿不落脚	爱飞
牵哈巴狗走路	跟腚了 定腚了
二五子炒菜	不是滋味
半路上杀出程咬金	突如其来
刘秀走国	到一处败一处
半夜起来回娘家	求日疯了
棍儿打王八	越打越缩脖
烧香抠尻子	惯使了手脚
卖西瓜的磨刀	傻瓜 杀瓜
眼皮上贴金	睁眼是钱
呼瘘包儿吐血	没得痰的 没得谈的
老牛撵兔子	有劲使不上 有劲儿使不上 有力无处使 有力使不出 有力追不上
西瓜掉到油篓里	滑蛋 大滑蛋 滑头滑脑 滑皮
从芦席上跌到地上	只差一点点
鼻子下面挂电灯	闻明 闻名
弹花匠的女儿	会弹不会纺 会谈不会访 只会弹,不会纺 只会谈,不会纺 只会谈 只会弹 会谈不会纺 会谈不会仿
大水冲崩关帝庙	慌了神
赔了夫人又折兵	双重损失 一举两失
南山的老鸹	白脖
麻雀搜糠	空欢喜
屎壳郎吃肉	昏头 荤头
无钱后才断赌	不济事
见了和尚喊姐夫	乱攀亲
苍蝇落在酒瓶里	没有出路
扁担插进桥眼儿里	担不起
老牛捡钱	没得啥用处
断了箍的木桶	散了架
腐朽的绳索	一冲而断
老鼠咬箱角	家贼难防
矿工上班	最底层
包公杀亲侄	先治其内 后治其外 先治其内,后治其外
三个钱摆两处	一是一,二是二
孔夫子写信	不起草稿 不打草稿
扫把写诗	好大话
提着葡萄要饭	穷酸
一篮虾倒在地上	活蹦乱跳
刺拐棒弹棉花	越整越乱
讨吃子偷碳锤	一圪溜儿
借着和尚骂贼秃	指桑骂槐
毛驴子拉车	埋头苦干
寡母婆	经不得媒劝 心不定
刘备报仇	因小失大
端公变的	乱跳坛
三人长的两根胡子	稀少
鲁班门前夸手艺	不知身份
油罐里打跟斗	胡闹 壶闹
秀才作医	如菜作齑
水银柱	不稳定 能上能下
天安门前的石狮子	明摆着 对摆着
冬水田种麦子	怪栽 怪哉
穿过胡同上大街	路子越走越宽
吃烧红苕的	喜欢吹捧拍
十五块布做的衣服	七拼八凑
丑仔做官	不成样
老和尚梦里接女人	想邪了心
两个老汉亲嘴	对呼 对胡
二十五个火把	好场合 好长火
茅缸里的石头	又臭又硬 臭硬 又硬又臭
针尖麦芒	各不相让 谁也不让谁
笼屉里取糠窝窝	手到勤拿
沙锅子倒蒜	一锤子买卖
山猫咧嘴	笑面虎
龙王摆筵席	净是海鲜 净尝海味儿
小虫落到牌坊上	头不大,架子不小
歪嘴上讲台	活现眼
蚧蛙跳门槛哩	既礅尻子又伤脸
三个小鬼拿不着他	比鬼还鬼
大虾炒鸡爪	蜷着腿,拱着腰 弓腰蜷腿 蜷着腿弓着腰 蜷腿带拱腰 抽筋带弯腰
打酥油的棒棒	直来直去 直进直出 直出直入
好心当作驴肝肺	不识好歹
耙红苕揩屁股	倒巴一陀
阎王老爷的布告	鬼话连篇
荞麦面见风	越来越硬
并底里扑腾	死不死,活不活
吃饱饭的粑粑	随便
棒槌轧勒木排里	轧大淘
老鼠掉到书箱子里	鸟文夹字 咬文嚼字
老马学蹿	跳不起来
巷道扛椽子	直来直去 直出直入 直进直出
石乌龟吃水	口勿饮肚 口不应肚 口勿应肚 心口不一 口不饮肚
红薯照镜子	体面苕
一排爆竹	连片带炸 连骗带诈 连鞭带炸 连编带诈
高粱秸拴骡子	拉倒
鸭屎瓜	表皮靓
庙里放炮	精神 惊神
黄鳝晒太阳	假死
釜中游鱼	不知死活 死活不知
属姜子牙的	能掐会算
和尚拜丈母	栖身何处 妻身何处 头一回 没遇着过 第一遭
柳条枝子穿王八	一个也跑不了
远路人趟水	不知深浅
瘫子赶强盗	坐着呼喊
草人讲话	口气不硬
二月二吃煎饼	闲磨 咸馍
谈今博	古 鼓
关公耍大刀	红脸上场 拿手好戏
小巴狗撵月亮	妄想 望享
春天打兔子	不是季节
木造火筒	事事不通
三脚砖头	摆不平
刀架心头上	忍了 忍吧
小孩子吹海螺	多、多、多
坐在盆上放屁	响不起 响不起来 想不起 想不起来
敲着空碗唱戏	穷开心
夜壶里炖萝卜	腌�H菜 真是不嫌腌�H
过了火的猪脑壳	焦头烂额
三岁小孩喝蜂蜜	里里外外甜透了
歪脖子拉小提琴	两全其美
羊粪蛋里掉个落花生	是个好仁 是个好人
鸡毛夹火炭	毛焦火辣的
豆腐渣垫鞋	不顶用 不顶事
金荡瓮老鼠	吃骨
人巴结有钱儿的,狗咬提篮儿的	小人一个
吃猪头不用筷	牙啃啃
板车拖稀饭	韵地足 运的粥
懒老婆坐轿	愿上不愿下
癞蛤蟆掉粪坑	不好开口 越搞越臭
心坎上挂笊篱	捞心了 劳心了 劳心 捞心 多劳这份心 多捞这份心
口吃橄榄	先苦后甜
桥顶上盖楼	上下空
酱园店里的糖生姜	外甜内辣
打场不用耢石	光棍 光磙
嘴里含灯草	说得轻巧
五月黄梅天	无情 无晴
络腮胡子吃麻糖	撒扯不开 撕扯不开
蘸着蜂蜜吃甘蔗	甜上加甜
歪嘴婆娘7大椒	假拉正
老太婆死脱大囡	无望 呒望
胸脯子挂笊篱	多劳 多捞
合闸的马达芯子	团团转
黄鼠狼吃天鹅肉	心高妄想
吃点退烧药	降降温
煎熬过的中药	要不得 全是渣滓
门背后头吃馍馍	自已哄自己
琉璃釉子	浮面儿 成不了多大气候
点灯跳水	无想死
死牢里的囚犯	谁也甭想出去 谁也别想出去
板凳上钻窟窿	有板眼 有板有眼
赶着老母猪打猎	送肉去
冬瓜烂囊	里面烂出
土地老挖耳朵	崴泥了
笼布才地	拉花花的
和尚吃猪肝,甲人知八利	心里自明
街浪相拍灰尘	全落勒众人眼里
城隍山上看火烧	幸灾乐祸
母鸡戴眼镜	冠小架子大 官小架子大
圩里张家的鳖	误了
游览全世界	见多识广
属麻花的	拧着劲儿 有点焦 有点脆 有点娇 欠搓
狗头上戴瓦罐	瞎碰
黄鳝毛做棉絮	办不到 没法办
猪八戒耍大刀	不顺手
屠宰场里的肥猪	末日来临了
癞蛤蟆骑水老鼠	假充马队的
省城的叫化子	口头高
哼木鱼撵鸭子	进口的货
整篓洒香油,满地拣芝麻	大处不算,小处算
山上喊话山下落	遥相呼应
屙屎打喷嚏	两头使劲 两头背时 两头蚀 两头背失 双舍
酱碗里的苍蝇	肮脏肉
武大郎的身材	不够尺寸
咸菜蘸大酱	太盐重了 太严重了 严重 盐重
卖了媳妇买大烟	上大瘾了
粗糠搓绳子	无法起手
新学的吹打手	拿不稳槌
金刚钻穿过钢铁板	过硬
旗杆顶上挂地雷	空响 空想
炉里的渣滓	有用的不多
老狼酗酒	受罪了 兽醉了
墙上画饼子	能看不能吃
隔门缝看人	扁看人
背锅睡在坟顶上	不知手脚高低
棺材里打架	死对头
肚子里怀了个地图	知晓天下事
煤球搬家	倒霉 倒煤
背锅睡在墓圪堆上	不知脚手高低
酒楼例汤	整定
鲜花插在了牛粪上	不相配
篾条贯豆腐	提不得
张公养鸟	越养越小 死多活少
闫王爷的炒器勒	鬼豆豆儿
棺材顶烧炮杖	吓死人
天津的萝卜	心里美
三尺的城门五尺汉	不能不低头
哑巴被狗咬	有口难言
散了的戏	收场了
倒了磨砸碾	石打石 实打实
猪八戒卖猪肝	难得的心肠
蛤蟆跌进屎坑	开不得口
李香香死了丈夫	没有喜望 没有希望
最宽的视野	一览无余
葫芦里灌水	吞吞吐吐
大寺的白果树	寿星
红薯眨巴眼	活苕
老何家姑娘嫁给老郑家	郑何氏 正合适
正月十五贴吊钱	晚了半个月
芦席上滚到地下	差不多 差勿多
当家神卖土地	一贫如洗
大年五更吃饺子	没外人 没有外人
讨吃子娶他妈	穷接擦 穷将就
韦驮耍宝剑	无主 无杵
屎壳郎赶庙会	一群一帮的
盲人给盲人带略	瞎扯
出门在外	人生 人参
招财进	宝
吃甘蔗渣子	没有味
饥了吃鞋帮	心中有底
老鹰不落地	干旋
火赤练出须	老蛇
一两面熬锅饭	不愁 不稠
多吃鸡下巴	就爱搭嘴
裙子套着裤子穿	不男不女
杉树尾	不够料 不成材
大道边儿的驴	谁爱骑就骑
飞机上吊电壶	水平高
石板上剁猪头	难下刀
灶王爷嘴上抹糖	拣甜话说
脚拐上抹眼泪	哭得好痛
狗舔砂罐	没得味
花盆里种庄稼	收获不大
鸭吃螺蛳	囫囵吞
灶火里列蛤蟆	灰爬
瞎子买鞋	摸摸脚
脚后跟扎刀子	离心远着哩 离心远着哪
脑门上抹糨子	糊涂到底了 糊涂到顶了
赶母猪上树	硬逼
庙儿后头筛灰渣	荡扑泥胎木偶哩 荡扑神神郎家哩
麻雀爪子上宴会	小蹄大作 小题大做
老和尚种黍子	干忙吃不上
瞎子去石头	乱扔
屋里喂老虎	不怕死 死都不怕
三十晚上晒衣裳	今年不干明年干
头上插鸡翎	好威风
土地爷卖房子	神不住 盛不住
打呼噜听见放炮仗	吓了一大跳
屎缸边吃月饼	不好开口
趁着热汤下笊篱	赶紧 正是时候
聋子拉二胡	胡扯 瞎扯
大米里头撒黑豆	现撒撒了
胡萝卜开花	打伞
罗汉骑牲口	马上见鬼
吃了火墨炭	黑了心
喇叭手敲鼓	自吹自擂
翰林院里打黄伞	到了何等地步
耩看耧眼	走着瞧
小二姐的裹脚	又臭又长 又长又臭
青藤缠老树	扭得紧
枕头底下的风	听也是听,不听也是听
济公出家	吃荤不吃素
老猴掰玉米	专拣嫩的捏
属捻捻转的	拨到哪儿在哪儿
姜太公里坐骑	四不像
灰鼠摘月亮	高攀不上
麻将牌夺勒河里	牌潮
园里选瓜	越选越差
叫花子吃螃蟹	津津有味 只只好
苞米棒喘气儿	吹胡子
汤罐里的小麦	面熟
扁担拍倒	一字平
养媳妇哭老公	说不出的苦
额头上戴毛壳刺	假充马鹿
赵匡胤赌钱	输打赢要 输打羸要
拆啧观音堂,造啧五圣殿	勿合算
皇帝老爷伸脚	灯笼 登龙
癞格宝戴眼镜	假充地理先生
秃子头上的疤	明摆着
狗食猪利	噍舌头 胡言乱语
鸡蛋壳里睡觉	想得宽绰
潘仁美领兵	苦了杨家将
精屁股撵狼	胆大不害羞
孙猴儿掉井里	心里凉透了
火烧水浸柴	难燃 难言
豆油氽黄豆	诈自家人 炸自家人
脱了水的海蜇子	软了下来
锦被遮鸡笼	做面
麻子吃辣豆腐	辣麻辣麻
十二岁出嫁	活做孽
张飞的胡子	满脸 硬碜 满脸都是 硬茬 硬岔 楂楂子 乱安
黄鼠狼叼鸡	有去无回
瘸子和尚说法	能说不能行
从斜门缝看人	怎么看怎么歪
大锤打在铁砧上	声声脆
寿星佬上吊	活得不耐烦了
豆芽子长一房高	也是菜 也是个吃菜货
皇帝挑媳妇	不嫁也得嫁,嫁也得嫁
抬头掉帽子	太望高了
吃饭淘米汤	过粥瘾
磨道里寻你的驴蹄印	哪还有寻不见的
官老爷下轿	步行 不行
留作种子的黄瓜	挂起来了
煤粉石灰掺一起	黑白不分 混淆黑白
盐罐子里冒烟	盐气 厌弃 咸气 嫌弃
狗咬壮腿	无处下口
面店里跌筋斗	粉身碎骨
梦黑里结婚	好事不成
怀里放炮	心里想 心里响
半斤面倒在尿壶里	和不成了 活不成了
塘里的莲花	根连着根
山西驴子不拽车	由不了它的意
朝廷爷的茅车	亮塌地哩
掏火棒儿短	强似手
猪八戒睡大觉	酣声如雷
马打架	看蹄 看题 不顾脸面
花蛇过溪	弯弯曲曲
如来佛身上贴膏药	佛帖 服帖
独眼龙看戏	一目了然
驼子背人	顶心
铁锤砸在被窝里	没回音 无回音 没反应 不见反应
土地菩萨淌汗	神虚
秋后的蛸蛸	不吱声了
喝血的蚊子	全凭嘴伤人
盘子里的鱼	休想动弹
一盘象棋下三下	棋逢对手
雪人见太阳	为时不久
扫帚疙瘩倒个个儿	没大没小
敞开锅子炒玉米	乱蹦乱跳
大虾跳在油锅里	该死
梦里坐朝廷	高兴一时是一时
比干宰相	无心
粗瓷茶碗	不能细雕
��牛不握架	怂馕子
剃头不给钱	昏头昏脑 混头混脑
圪绦虫挖奔子	偎偎不动
小孩放鞭炮	新鲜 又喜又怕
麻袋包装锥子	露了尖
罐子里装扁食	饭桶
老鹅觅螺不出声	伪装老实
一步楼	厕所
猴儿吃芥茉	翻白眼
狗吃螺丝壳	不吃掉不落
一锤打在棉堆上	没响 没想
隔着料吃草	混牛
程咬金三斧头	头三下子狠 开头凶
屎壳郎跑到炭篓里	不动弹显不出黑 不动弹显不着黑
船上撑伞	没天没地
老母猪巴搭嘴	要糟
花户布喇	各色
双喜则乃比斗	始终不神服
罐子掉了底	汉川
用石头砸自己的脚	自作自受
卖东瓜买西瓜	大去大来
懒汉种田	望明年 望来年
十不全上任	秃瘸瞎拐
蛐蟮爬石条	专走硬路
猪拱鸡窝	鸡飞蛋打
卖豆芽不带秤	乱抓
孔夫子尻子上别火镰	做君子防不燃 做君子防不然
黑瞎子蹲庙台	装象 装相 熊象 熊相
老太婆住高楼	上下两难
甘蔗当火筒	一节也不通
脑门上长瘤	额外负担
怀孕十月	升啦 生啦
盲佬吃云吞	心中有数
鸳鸯睡觉	交颈而眠
沙地人讲话	白肠白肚
缺腿的狐狸	没跑
羊群里拾来一只狼	遭后祸
妓女逛窑子	虚情假意 照顾自家人
扁担插进桥孔里	既不敢担,也担不起 担不起 一来不敢担,二来担不起
水爬虫变蜻蜓	一步登天 干脱身
驴粪蛋上滚白糖	内里坏
膝盖上钉马掌	离题太远 离蹄太远 不对题 不对蹄
母猪遛土豆	全凭一张嘴 全仗嘴
自行车走水泥马路	没辙
提起来的竹篙	眼泪汪汪向江河
如来佛出虚恭	好神气 神气
碾坨上挂气球	哪头轻哪头重,心里有数
大闺女祈祷	句句心里话
老鼠翻进白米缸	吃用勿
阎罗王搭鬼商量	鬼话鬼话
挂起犁杖当钟敲	穷得叮当响 穷得丁当响
闭着眼睛捉田螺	瞎摸一气
麦田里的狗尾草	良莠不齐
二更梆子打两下	没错 没有错
猎人出门遇上兔子出窝	巧得很 巧极了
带崽的山猪	恶过虎
叫化子吵嘴	穷嚼
堂屋打连枷	看上又看下
菩萨的胸膛	没心肝 没心没肝
老坟场儿里唱大戏	鬼看
棺材铺老板咬牙	恨人不死
猴吃核桃	满砸
蒺藜果	小刺儿头
强叫老鹰学百灵叫	叫不出来
潭柘寺的和尚	没数 没数儿
老猪婆撒屎石糟里	自害自身
一根筷的吃藕根	钻窟窟儿咧
大吵大闹	喊黄溅天
向太阳吐唾沫	顶不了雨
唐三藏的扁担	担惊 担经
细皮嫩	肉
好汉造反	逼上梁山
下棋的小卒儿	叫到哪就到哪 叫到哪,就到哪
相差无几	大同
蚊子腹中刳脂油	没多大油水 油水不大 没有油水
吃了白饭就拉屎	一根肚肠通到底
脑门生疮	坏到顶
豆腐渣子炒藕	糊眼子的事
下雨天不打伞	吝啬 淋湿
老鸦晒粪	用嘴拨
合金钢的钻头	专打硬仗的角色
作梦上花轿	想美事儿
老鼠蹭呐米缸里去	又想吃,又想走
老鼠爬冰凌	又尖又滑
红薯进灶	该煨
枯庙里的旗杆	独一根 独一无二
落蒂的甜瓜	熟透了
老虎卧马圈里	马马虎虎
和尚手里的木鱼	天生挨揍的货
门上里封条	扯不里
跛子打围	坐着喊 坐地呐喊
哈巴狗见了主子	俯首贴耳
冰上站人	久不了
额头上生疖子	触眉头 触霉头 坏到顶了
扛捞绞进庙	劳神 捞神
属沙枣红柳骆驼刺的	越是沙漠越活得好
纸角装盐	包涵 包咸
猴儿不上竿	硬敲锣 多敲几声锣 只用多敲锣
狗啃石狮子	不可思议
抱着火炉拉家常	句句暖心窝
扑乞者	展威风
山壁虎断尾巴	迷惑人
判官的肚子	鬼心肠
大头猫儿作揖	老虎拜 老腐败
一锹挖了个井	捅打在正经的地方上了
一个眼里母猪	瞎壳篓 瞎嗑喽
搬起楼梯上天	无门
眉毛勿遮风	意思意思
蘸了汽油的柴木	一点就着
粘豆粥糊锅	难铲 难产 难�a
小母牛做坦克	牛逼轰轰
裁缝戴眼镜	见缝插针 纫针 认真 以身作则
阎王爷扯谎	骗鬼
螃蟹落在芥菜上	不上不下 上不上,下不下
抱着金砖咽气	舍命不舍财 爱财舍命
糟鼻子吃酒	枉担其名
促织不吃癞虾蟆肉	都是一锹土上人
鳝鱼进毫子	只进不出
厨师做菜	油盐在先 有言在先
失意人逢得喜事	一番欢喜一番愁
一只糊钻刺包笼	还想那只眼睛瞎
另搭台子另唱戏	从头来 从头学起
光腚钻草堆	自己献丑
麦秆儿做眉毛	空不过
四金刚把橹	大推扳
擦上胭脂进棺材	死要面子
芝麻里个黄豆	独大
二小子买画	一样一张
女儿国招驸马	一厢情愿
癞肚子爬在脚背上	不咬人,狞人
一手抓癞,一手抓疮	有两手抓
麻雀躲在牌坊上	东西不大,架子倒不小
公园里看灯展	走着瞧
摆子老竹竿	一老一实
水湾里照影子	倒过来
百年松当烧柴	大材小用 屈材 屈才
串亲戚拿个屁	没那一礼 没那一理
眉字头	八
和尚勿吃荤	肚里有素 肚里有数
满头稻黍花	土气太大
香椿拌豆腐	一清二白 一青二白
南瓜花摊蛋皮	对色
狗不咬家人	是亲三分向
粘粥锅里煮皮球	说是糊涂蛋还有一肚子气
半路上新闻	道听途说
陈年的芝麻	没得用
云里长胡子	空虚 空须
动物园里的野兽	打不得
光着脚板踩玻璃碴儿	走险
老驴推磨	不离老地方
夜壶里出烟	臊气劲儿
丰都城里唱大戏	鬼听
花岗石脑壳	不开窍
十一只鞋子打掌	分不出五阴六阳
壁虎的尾巴	活的 节节活
双脚踩在棉花堆上	不踏实地 也不敢迈步 不踏实
下暴雨泼污水	销赃 消脏
蛤蟆充田鸡	差得远
屎壳郎喝糖水	嘴变甜了
裤带拴银柜	钱上取齐
叫花子搭车	往哪去都顺路
猫儿抓老鼠	祖传手艺 本能 祖传秘方
老鼠拉绳子	不知从哪头咬
二十里不换肩	抬杠的能手
小偷搓泥球	贼圆
南院门的乡约	尥方紧张
半夜开门	郎回
玻璃建房	八面见光
丫鬟拿钥匙	当家不做主
粪缸盖上搭凉棚	臭架子
火星爷的耳巴子	热手
大门口挂粪桶	臭名在外
小猪鼻子	有点儿圆 有点儿缘
小车卧倒	翻儿了
三钱买个筛子	眼不好
大年三十晚上熬稀粥	年关难过
冷口哺热食	正好
小学生不认识加号	十字
狗咬猪屎胞	一场空欢喜
莲藕不切节	两头都不通
猫儿谈情	怪叫
六月里借扇	不识时务
吕太后的宴席	不好进口 不是轻易吃得的
粪池头槛爿	抵急
黄河水	难清 倒不完 难请 道不完
古戏装	华而不实
清水�づＦ�	无紧无慢
汪精卫炒韭菜	汉奸造谣 汉奸造肴
耗子掉进拌种箱	上上下下老打转 上下打转 无处奔
叫花子死了大张嘴	穷语未尽 穷语噜嗦
裤裆的虱子	拉球上跑也
炊事员拍屁股	坏了菜
火罐柿树结板柿	柿大了 事大了
屙屎放屁	有虚有实
围桶起波浪	发了屁眼风
割下个锅盖没梁子	哪里来的拍拍匠
火柴棍搭桥	难过 不成
脚盆里和面	不知香臭 闻不着香臭
粉皮耳朵	不顶用
傻子抽水烟	连吃带喝
枣核掉油桶	又尖又滑
隔墙相媳妇	不知好歹 好歹不分
要甜的拿糖碗,要酸的拿醋罐	一行是一行
送行的饺子,洗尘的面	费事也得包
寒冬腊月吃冰棍儿	凉透了
山头打虎	高名在外 大名在外
罐子掉了鼻儿	别提了
卖枣里碰见卖碗里	早早晚晚 枣枣碗碗
鸭子住在大树上	笨鸟上高枝
张满风的帆船	好大的力气 劲大 劲不小
顶风拉屎,顺风打旗	两边倒
罐子里栽莲花	沤死了 藕死了
小吖滴鸡鸡	越捞越硬
崇祯后期	大势已去
卖鸡的同卖鸭的	大伙同行
双马碌碡单马拉	一个顶俩
孤舟出海	敢冒风险
屎壳螂爬到桑叶上	吐不出好丝来
三斤面包个饺子	好大的面皮 皮厚
背篼里摇铜铃	乱想 乱响
枣核子解板	没拉头 没啦头 没几句 没几锯 两句 两锯 搁不住锯 搁不住句
顺水行船	趁方便
木匠打儿媳妇	有尺寸
铺盖头听广播	自得其乐
秀才碰到兵	有理说勿清 有理说不清 有理讲不清
卖煎饼果子的跌跤	乱套了
乱线团掉刺窝	难理清
筷子上穿线	无眼
出头的疖子	好得快
外国人照合影相	洋相不少
坐着飞机想上月球	心比天高
屎克螂跟着屁哄哄	虚的实的都没捞到
老酒店	差不了壶
厕所里七瓜子	出大头子,进小头子
拳头劈砖头	硬功夫
冰冻豆腐	太冷淡
一口吞五十只麻雀	百爪挠心
瘤火腿子遭蛇咬	总是个肿
卖梨膏的盖楼	得几年熬 熬的
